3       4        5        6             
++++++++++++++++++++++++++++++++++++++++
+++++ + +        +X X X X +      T     +
+                +            T  T   T +
+   +++++        +        +   T      T w
+    +++++++++++++        +   T  T   T +
+++++++   AB     D        +   T  T   T +
+       ++++++++++        +      T     +
+ + +++++        +        +   T  T   T +
+>+++   +        + X X X X+   T      T w
++++++++++++++++++++++++++++++++++++++++