1         2         3         4         5         6          
+++++++++++++++++++++++++++++++++++++++++++++++++++++++++++++
+  +++++ ++A        +++++ + +++         +         +X X X X X+
+ v +   +++++++     D   + +      0      +++++++++++         +
+   +++++++      ++++ + +   + +         D  T T              +
+   + +             +         +         +         +         +
+   + +   +   B     +++++++++++0 0      +TTTTTTTTT+         +
+   +++  ++         +       +++   0 0   +     T   +         +
+   +    ++++++++++++         +         + T   T   +         +
+   +++++++         +         +         +     T   +         +
+         +         +         +         +     T   +         +
+         +         +         +  0      + T T T   + X X X X w
+++++++++++++++++++++++++++++++++++++++++++++++++++++++++++++