1                   
++++++++++++++++++++
+ v                +
+                  +
+                  +
+                  +
+                  +
+                  +
+                  +
+                  +
+                  +
+                  +
+                  +
+                  +
++++++++++++++++++++