1        2       3       4        5        6             
+++++++++++++++++++++++++++++++++++++++++++++++++++++++++
+ v +    +    0  +++++ + +        +X X X X +      T     +
+   +  + + 00 00 +           B    +            T  T   T +
+   +  + + 00 00 + +++++++        +        +   T      T w
+ +++  + + 00  00+       ++++++   +        +   T  T   T +
+ +++  + + 0   0 +++++++ ++++++   D        +   T  T   T +
+ +    + +       +     + + A+++   +        +      T     +
+ + ++++ +0      +   + + +        +        +   T  T   T +
+ + +++      0   D   +   +        + X X X X+   T        w
+ + ++++         ++++++++++++++++++++++++++++++++++++++++
+ + +  +         ++++++++++++++++++++++++++++++++++++++++
+ + +  +         ++++++++++++++++++++++++++++++++++++++++
+   +  +    0    ++++++++++++++++++++++++++++++++++++++++
+++++++++++++++++++++++++++++++++++++++++++++++++++++++++